8
0 6 1
1 12 1
0 13 1 
1 15 1
2 16 4
0 14 2
2 22 1
0 22 4
22
1 0 0 0 0 0
1 2 0 0 0 0
1 2 3 0 0 0
1 2 3 4 0 0
1 2 3 0 0 0
1 2 4 0 0 0
1 2 2 0 0 0
7 2 0 0 0 0
1 0 0 0 0 0
1 0 0 0 0 0
3 0 3 0 0 0
3 0 3 5 0 0
3 0 3 0 0 0
1 0 0 0 0 0
1 4 0 0 0 0
1 4 4 0 0 0
1 4 0 0 0 0
1 0 0 0 0 0
1 0 0 0 0 0
1 0 2 0 0 0
1 0 2 0 0 0
1 0 2 0 0 0
