8
0 3 2
0 4 3
0 15 3
0 16 1
0 17 3
0 21 3
1 9 1
1 20 1
22
1 0 0 0 0 0
1 0 0 0 0 0
1 0 3 0 0 0
1 0 3 0 0 0
1 0 3 0 0 0
1 0 0 0 0 0
1 0 0 0 0 0
1 4 0 0 0 0
1 4 0 0 0 0
1 0 0 0 0 0
1 0 2 0 0 0
1 0 4 0 0 0
1 0 0 0 0 0
1 0 0 0 0 0
1 0 0 2 0 0
1 2 0 0 0 0
1 0 0 2 0 0
1 2 0 0 0 0
1 0 0 0 0 0
1 2 0 0 0 0
1 2 2 0 0 0
1 2 2 0 0 0
