9
0 3 1
0 14 3
0 15 3
0 19 1
0 12 3
1 19 2
1 5 0
1 5 2
1 7 3
22
1 0 0 0 0 0 0 0
1 2 0 0 0 0 0 0
1 2 2 0 0 0 0 0
1 2 2 0 2 0 0 0
1 2 2 0 2 0 0 0
1 2 0 0 2 0 0 0
1 2 0 2 2 0 0 0
1 2 0 0 2 0 0 0
1 2 2 0 2 0 0 0
1 2 2 0 2 0 0 0
1 2 2 0 2 0 0 0
1 4 0 0 0 0 0 0
1 0 0 0 0 0 0 0
1 0 0 0 0 0 0 0
1 0 0 2 0 0 0 0
1 2 0 0 0 0 0 0
1 0 0 2 0 0 0 0
1 2 0 0 0 0 0 0
1 0 0 0 0 0 0 0
1 2 0 0 0 0 0 0
1 0 2 0 0 0 0 0
1 0 2 0 2 0 0 0
