9
0 3 1
0 21 1
0 19 3
0 12 2
1 3 1
1 14 3
1 7 3
1 19 3
1 31 2
32
1 0 0 0 0 0 0 0
1 2 0 0 0 0 0 0
1 2 2 0 0 0 0 0
1 2 2 0 2 0 0 0
1 2 2 0 2 0 0 0
1 2 0 0 2 0 0 0
1 2 0 2 2 0 0 0
1 2 0 0 2 0 0 0
1 2 0 0 2 0 0 0
1 2 0 0 2 0 0 0
1 2 0 0 2 0 0 0
1 3 0 3 3 0 0 0
1 3 0 0 0 0 0 0
1 0 0 3 0 0 0 0
1 0 0 2 0 0 0 0
1 2 0 0 0 0 0 0
1 0 0 2 0 0 0 0
1 2 0 0 0 0 0 0
1 0 0 0 0 0 0 0
1 0 0 0 0 0 0 0
1 0 2 0 0 0 0 0
1 0 2 0 2 0 0 0
1 0 0 0 0 0 0 0
1 2 0 0 0 0 0 0
1 2 2 0 0 0 0 0
1 2 2 0 2 0 0 0
1 2 2 0 2 0 0 0
1 2 0 0 2 0 0 0
1 2 0 2 2 0 0 0
1 2 0 0 2 0 0 0
1 2 2 0 2 0 0 0
1 2 2 0 2 0 0 0
1 2 2 0 2 0 0 0
1 2 2 0 2 0 0 0
