9
0 5 4
1 3 2
1 14 3
1 7 3
0 17 2
1 18 2
1 21 1
0 22 4
2 31 4
32
1 0 0 0 0 0
1 0 5 5 5 5
1 0 0 0 5 5
1 0 5 0 8 5
1 0 5 0 0 5
1 0 0 0 0 5
1 0 5 0 0 5
1 0 5 5 0 0
1 0 0 5 0 0
7 0 0 5 0 0
0 0 0 5 0 0
0 5 0 5 0 0
0 5 0 0 0 0
0 0 0 0 2 2
1 0 0 0 2 2
1 0 2 0 2 2
1 0 2 0 0 0
1 0 0 0 0 0
1 6 6 0 0 0
1 7 0 0 0 0 
1 7 0 0 0 0
1 8 0 0 0 0 
1 0 0 0 0 0
1 6 0 2 0 0
1 0 0 2 2 0
1 0 0 2 0 0
1 6 0 0 0 0
1 8 0 0 3 0
1 0 0 0 0 0
1 0 0 0 3 0
1 0 0 0 3 0
1 0 5 5 5 5
1 0 5 5 5 5
