9
2 2 2
2 3 2
2 14 3
2 7 3
2 17 2
2 18 2
2 21 1
2 22 4
2 31 4
32
1 0 0 0 0 0 0 0
1 0 5 5 5 5 0 0
1 0 0 0 5 5 0 0
1 0 5 0 8 5 0 0
1 0 5 0 0 5 0 0
1 0 5 0 0 5 0 0
1 0 5 0 0 5 0 0
1 0 0 5 0 0 0 0
1 0 0 0 0 0 0 0
7 0 0 0 0 0 0 0
0 0 5 5 0 0 0 0
0 5 8 0 0 0 0 0
0 5 0 0 1 0 0 0
1 0 0 1 0 0 0 0
1 0 0 0 0 0 0 0
1 0 2 0 0 0 0 0
1 0 2 0 0 0 0 0
1 0 0 0 0 0 0 0
1 0 6 0 0 0 0 0
1 3 0 0 0 0 0 0
1 7 0 0 0 0 0 0
1 8 0 0 0 0 0 0
1 0 0 0 0 0 0 0
1 6 0 0 0 0 0 0
1 0 0 0 2 0 0 0
1 0 0 0 0 0 0 0
1 6 0 0 0 0 0 0
1 8 0 0 3 0 0 0
1 0 0 7 0 0 0 0
1 0 0 8 0 0 0 0
1 0 0 0 0 0 0 0
1 0 6 0 6 5 0 0
1 6 5 0 5 5 0 0
